gold	corrupted	error_pred	bad_word
за день до этого демонстранты блокировали в банкгоке здание парламента и ряда министерств .	за день до этого демонстранты блокировали в банкгоке здание парламента и ряда минфдстерстдв .	за день до этого демонстранты блокировали в банкгоке здание парламента и ряда минфдстерстдв .	министерств / минфдстерстдв
какое демографическое будущее ждет европу ?	какое демографическое будущее жидет европу ?	какое демографическое будущее будет европу ?	ждет / будет
в третьей фразе про фильм тауэлхед - ...	в тртехтьей фразе про фильм `` тауэлхед '' - ...	в тртехтьей фразе про фильм тауэлхед - ...	третьей / тртехтьей
глава концерна алан муллали заявил , что будет работать за символический NUM доллар в год , если государство поможет ford .	глава концерна аланщ муллали заявил , что будет работать за символический NUM доллар в год , если государство поможет ford .	глава концерна аланщ муллали заявил , что будет работать за символический NUM доллар в год , если государство поможет ford .	алан / аланщ
он перестал видеть панель управления и подал сигнал о помощи , - рассказывал позже военный авиадиспетчер энди хинд .	он перестал видеть панель управления и модеал сигнал о помощи '' , - рассказывал позже военный авиадиспетчер энди хинд .	он перестал видеть панель управления и модеал сигнал о помощи , - рассказывал позже военный авиадиспетчер энди хинд .	подал / модеал
жительница расположенного неподалеку села дзриа рассказала корреспонденту , что чуть менее половины ( NUM из NUM ) грузин , проживавших в переви , покинули свои дома .	жительница расположенного неподалеку села дзриа рассказала корреспонденту , что чуть менее половины ( NUM из NUM ) гриуин , проживавших в переви , покинули свои дома .	жительница расположенного неподалеку села дзриа рассказала корреспонденту , что чуть менее половины ( NUM из NUM ) гриуин , проживавших в переви , покинули свои дома .	грузин / гриуин
в NUM году премия досталась украинцу андрею шевченко .	в NUM году премия досталась украинцу анддрев шевченко .	в NUM году премия досталась украинцу андрея шевченко .	андрею / андрея
несколько десятков арабов забросали камнями блокпост цахала на площади кикар а-шотэр в хевроне .	несколько десятков арабов змабрйосалпи камнями блокпост цахала на площади кикар а-шотэр в хевроне .	несколько десятков арабов змабрйосалпи камнями блокпост цахала на площади кикар а-шотэр в хевроне .	забросали / змабрйосалпи
он стал наследником престола в NUM-летнем возрасте , а в NUM году в замке карнарвон в уэльсе королева возложила на голову сына венец принца уэльского .	он стал наследником престола в NUM-летнем возрасте , а в NUM годку в замке карнарвон в уэльсе королева возложила на голову сына венец принца уэльского .	он стал наследником престола в NUM-летнем возрасте , а в NUM годку в замке карнарвон в уэльсе королева возложила на голову сына венец принца уэльского .	году / годку
отчет касается только членов оэср ( россия в него не входит ) .	отчет касается только членов оэср ( россия э него не входит ) .	отчет касается только членов оэср ( россия у него не входит ) .	в / у
он лауреат премий адама смита за NUM год и ректенвальда за NUM год .	он лауреат премий адама смита за NUM год и ректенвальда ёа NUM год .	он лауреат премий адама смита за NUM год и ректенвальда ёа NUM год .	за / ёа
элен диженерес начала свою телевизионную карьеру в NUM году и стала первой ведущей американского тв , открыто позиционирующей себя как лесбиянка .	элен диженерес начала свою телевизионную карьеръщ в NUM году и стала первой ведущей американского тв , открыто позиционирующей себя как лесбиянка .	элен диженерес начала свою телевизионную карьеръщ в NUM году и стала первой ведущей американского тв , открыто позиционирующей себя как лесбиянка .	карьеру / карьеръщ
в ближайшее время в странах евросоюза пройдут более NUM мероприятий , связанных с трудостройством : ярмарок вакансий , семинаров , дней открытых верей .	в ближайшее время в странах евросоюза пройдут более NUM мертхреятий , связанных с трудостройством : ярмарок вакансий , семинаров , дней открытых верей .	в ближайшее время в странах евросоюза пройдут более NUM мертхреятий , связанных с трудостройством : ярмарок вакансий , семинаров , дней открытых верей .	мероприятий / мертхреятий
единственный захваченный живым участник терактов в мумбаи , уроженец города фаридкот в провинции пенджаб на юге пакистана , NUM-летний азам амир касаб , дал показания индийским следователям .	единственный захваченный живым унастнуик терактов в мумбаи , уроженец города фаридкот в провинции пенджаб на юге пакистана , NUM-летний азам амир касаб , дал показания индийским следователям .	единственный захваченный живым унастнуик терактов в мумбаи , уроженец города фаридкот в провинции пенджаб на юге пакистана , NUM-летний азам амир касаб , дал показания индийским следователям .	участник / унастнуик
источники сообщают , что глава renault-nissan карлос гон направил свое предложение главному акционеру chrysler , инвестиционному фонду cerberus и что гендиректор фонда стивен фейнберг на сделку в принципе согласен .	источники сообщают , что главеаз renault-nissan карлос гон направил свое предложение главному акционеру chrysler , инвестиционному фонду cerberus и что гендиректор фонда стивен фейнберг на сделку в принципе согласен .	источники сообщают , что главеаз renault-nissan карлос гон направил свое предложение главному акционеру chrysler , инвестиционному фонду cerberus и что гендиректор фонда стивен фейнберг на сделку в принципе согласен .	глава / главеаз
это первое происшествие такого рода после отстранения от должности президента ингушетии мурата зязикова NUM октября этого года .	это первое происшествие такого рода после отстранения от должности президента ингушетии мурата зязикова NUM оътяюря этого года .	это первое происшествие такого рода после отстранения от должности президента ингушетии мурата зязикова NUM оътяюря этого года .	октября / оътяюря
по данным опросов , берлускони по-прежнему популярен	"по данным опросов, берлускони по-прежнему популярен
"	по данным опросов , берлускони по-прежнему популярной	популярен / популярной
чтобы справиться с возникающими в экономике проблемами , правительство кнр ввело ряд временных мер , включающих снижение налогов и увеличение инвестиций в инфраструктуру .	чтобы справиться с возникающими в экономике проблемами , правительство кнр ввело ряд временных мер , включающих снижение налогов и увеличение ицвестбициъ в инфраструктуру .	чтобы справиться с возникающими в экономике проблемами , правительство кнр ввело ряд временных мер , включающих снижение налогов и увеличение инвестиции в инфраструктуру .	инвестиций / инвестиции
новая лента дэнни бойла - на этот раз знаменитый режиссер , постановщик знаменитого пляжа и трейнспотиннга , обращается к истории , случившейся с ...	новая ленвтпа дэнни бойла - на этот раз знаменитый режиссер , постановщик знаменитого `` пляжа '' и `` трейнспотиннга '' , обращается к истории , случившейся с ...	новая ленвтпа дэнни бойла - на этот раз знаменитый режиссер , постановщик знаменитого пляжа и трейнспотиннга , обращается к истории , случившейся с ...	лента / ленвтпа
таким образом ученые испытывают новый класс материалов , известных как интерметаллические и обладающих привлекательным разнообразием механических и химических свойств .	тащуим образом ученые испытывают новый класс материалов , известных как интерметаллические и обладающих привлекательным разнообразием механических и химических свойств .	тащуим образом ученые испытывают новый класс материалов , известных как интерметаллические и обладающих привлекательным разнообразием механических и химических свойств .	таким / тащуим
с тех пор он прошел все судебные инстанции и теперь надеется на решение высшего аппеляционного суда .	с тех пор он прошел все судебные инстанции и теперь ёнадеется на решение высшего аппеляционного суда .	с тех пор он прошел все судебные инстанции и теперь ёнадеется на решение высшего аппеляционного суда .	надеется / ёнадеется
по поступающим сообщениям , в гвинее-бисау в целом спокойно , но на улицах бисау дежурят военные патрули .	по поступающим сообщениям , в гвинее-бисау в целом спокойно , но на улицах бисау дехурятт военные патрули .	по поступающим сообщениям , в гвинее-бисау в целом спокойно , но на улицах бисау дехурятт военные патрули .	дежурят / дехурятт
в то же время они решили не предоставлять грузии и украине планов действий для членства в нато .	в то же время они решили не предоставлять друзии и украине планов действий для членства в нато .	в то же время они решили не предоставлять друзей и украине планов действий для членства в нато .	грузии / друзей
салим хамдан был захвачен в афганистане в ноябре NUM года .	салим хамдан был захвачен в афганистане в нтфябре NUM года .	салим хамдан был захвачен в афганистане в нтфябре NUM года .	ноябре / нтфябре
кризис бизнес-модели инвестиционных банков в сша оставил на рынке только двоих - morgan stanly и goldman sachs .	кризис бизнес-модели инвестиционных банков в сша остфавщил на рынке только двоих - morgan stanly и goldman sachs .	кризис бизнес-модели инвестиционных банков в сша остфавщил на рынке только двоих - morgan stanly и goldman sachs .	оставил / остфавщил
в сентябре NUM боевики похищают председателя союза предпринимателей фрг ганса-мартина шлейера и требуют освобождения старших товарищей .	в сентябре NUM боевики похищают председателя лоюза предпринимателей фрг ганса-мартина шлейера и требуют освобождения старших товарищей .	в сентябре NUM боевики похищают председателя лоюза предпринимателей фрг ганса-мартина шлейера и требуют освобождения старших товарищей .	союза / лоюза
самые скромные потери - NUM % - понесла в среду биржа лиссабона , чемпионом оказался лондонский футси-NUM , упавший на NUM , NUM % .	самые скромные пэбтери - NUM % - понесла в среду биржа лиссабона , чемпионом оказался лондонский `` футси '' -NUM , упавший на NUM , NUM % .	самые скромные пэбтери - NUM % - понесла в среду биржа лиссабона , чемпионом оказался лондонский футси -NUM , упавший на NUM , NUM % .	. / %
вместе с тэмми дакворт , которая потеряла в ираке ноги , и которая , видимо , сменит его на посту сенатора от штата иллинойс , обама возложил венок к военному мемориалу в чикаго .	вместе са тэмми дакворт , которая потеряла в ираке ноги , и которая , видимо , сменит его на посту сенатора от штата иллинойс , обама возложил венок к военному мемориалу в чикаго .	вместе са тэмми акорт , которая потеряла в ираке ноги , и которая , видимо , сменит его на посту сенатора от штата иллинойс , обама возложил венок к военному мемориалу в чикаго .	дакворт / акорт
об аудиенции у папы рассказал раввин давид розен , возглавляющий делегацию международного еврейского комитета по межрелигиозным консультациям .	об аудиенции у папы рассказал раввин давид рошхен , возглавляющий делегацию международного еврейского комитета по межрелигиозным консультациям .	об аудиенции у папы рассказал раввин давид рошхен , возглавляющий делегацию международного еврейского комитета по межрелигиозным консультациям .	розен / рошхен
если этого не делать , они будут обречены на живтоное существование .	если этого не делатсф , они будут обречены на живтоное существование .	если этого не делатсф , они будут обречены на живтоное существование .	делать / делатсф
тем временем кандидат на пост президента сша от республиканцев джон маккейн продолжил свою предвыборную кампанию и выступил на митинге в клорадо .	тем временем кандидат нна пост президента сша от республиканцев джон маккейн продолжил свою предвыборную кампанию и выступил на митинге в клорадо .	тем временем кандидат нна пост президента сша от республиканцев джон маккейн продолжил свою предвыборную кампанию и выступил на митинге в колорадо .	клорадо / колорадо
в этом получасовом фильме , который обошелся обаме как минимум в NUM миллиона долларов , демократический кандидат , в частности , вновь повторил обещание снизить налоги пообещал создать новые рабочие места .	в этом получасовом фпльбе , который обошелся обаме как минимум в NUM миллиона долларов , демократический кандидат , в частности , вновь повторил обещание снизить налоги пообещал создать новые рабочие места .	в этом получасовом фпльбе , который обошелся обаме как минимум в NUM миллиона долларов , демократический кандидат , в частности , вновь повторил обещание снизить налоги пообещал создать новые рабочие места .	фильме / фпльбе
таким финалом судебного разбирательства удивлены все - даже сам монтес .	"таким финалом судебного разбирательства удивлены все - даже сам монтес.
"	таким финалом судебного разбирательства удивлены все - даже сам монет .	монтес / монет
митинг сторонников республиканца начнется вечером и будет проходить в пятизвездочной гостинице класса люкс билтмор в центре феникса .	митинг сторонников республиканца начнется вечером и будет проходить в пятизвездочной гостинице класса люкс билтмор в центре фсеняикса .	митинг сторонников республиканца начнется вечером и будет проходить в пятизвездочной гостинице класса люкс билтмор в центре фсеняикса .	феникса / фсеняикса
ханиф курейши : - я об этом разговаривал вчера вечером со своим другом .	ханиф курейши : - я об этом разговаривал хвчераг вечером со своим другом .	ханиф курейши : - я об этом разговаривал хвчераг вечером со своим другом .	вчера / хвчераг
омар усама бин ладен с женой	омар усама бин хаденж с женой	омар усама бин ладена с женой	ладен / ладена
тогда динамовцы в четырех поединках против челси , арсенала , кардифф cити и глазго рейнджерс добились двух побед при двух ничьих с разницей мячей NUM : NUM в свою пользу .	тогда динамовцы в четырех поединках против `` челси '' , `` арсенала '' , `` кардифф cити '' и `` глазго рейнджерс '' добились двух побед при двух нючьщих с разницей мячей NUM : NUM в свою пользу .	тогда динамовцы в четырех поединках против челси , арсенала , кардифф cити и глазго рейнджерс добились двух побед при двух нючьщих с разницей мячей NUM : NUM в свою пользу .	ничьих / нючьщих
когда в конфликт попыталась вмешаться депутат катрина ходжкинсон , фрэзер ее грубо оттолкнул .	когда в конфликт попыталась вмешаться депутат катрина ходжкинсон , фрэзер иее грубо оттолкнул .	когда в конфликт попыталась вмешаться депутат катрина ходжкинсон , фрэзер иее грубо оттолкнул .	ее / иее
тайные скрижали ( the secret scripture ) - себастиан барри	`` тайные скрижали '' ( the secret scripture ) - щебастииазн барри	тайные скрижали ( the secret scripture ) - щебастииазн барри	себастиан / щебастииазн
журналист спрашивает : вы будете голосовать за обаму ?	"журналист спрашивает: ""вы будете голосовать за обаму?""
"	журналист спрашивает : вы будете голосовать за оба ?	обаму / оба
официально ответственность за теракт взяла на себя ранее неизвестная группировка , называющая себя деканские моджахеды .	официально ответственность за теракт взяла эна себя ранее неизвестная группировка , называющая себя `` деканские моджахеды '' .	официально ответственность за теракт взяла эна себя ранее неизвестная группировка , называющая себя деканские моджахеды .	на / эна
мы будем вкладывать в альтернативную энергиию : энергию солнца , ветра , приливов , в энергию атома .	мы будем вкладывать в альтернативную энергиию : энергию солнца , ветра , прихицвов , в энергию атома .	мы будем вкладывать в альтернативную энергиию : энергию солнца , ветра , прихицвов , в энергию атома .	приливов / прихицвов
вот об этом трики и поет свои грустные песни ...	вот обо этом трики и поет свои грустные песни ...	вот обо этом руки и поет свои грустные песни ...	трики / руки
алкоголь беременным можно , но немного , говорят врачи	алкктголь беременным можно , но немного , говорят врачи	алкоголя беременным можно , но немного , говорят врачи	алкоголь / алкоголя
в жанре политического памфлета и гиньоля снял две картины : хотим полковников и мелкий-мелкий буржуа .	в жанре пжолдитическфго памфлета и гиньоля снял две картины : `` хотим полковников '' и `` мелкий-мелкий буржуа '' .	в жанре пжолдитическфго памфлета и гиньоля снял две картины : хотим полковников и мелкий-мелкий буржуа .	политического / пжолдитическфго
как сообщает телеканал al-sharqiyah со ссылкой на коалиционное командование , организация , осуществлявшая ремонт и реставрацию зданий ввозила в ирак оружие и боеприпасы под видом стройматериалов .	как сообщает телеканал al-sharqiyah со ссылкой на коалиционное командование , организация , осуществлявшая ремонт и реставрацию зданий ввозила в ирак оружие и боеприпасы под видом сщроэмаштериалов .	как сообщает телеканал al-sharqiyah со ссылкой на коалиционное командование , организация , осуществлявшая ремонт и реставрацию зданий ввозила в ирак оружие и боеприпасы под видом сщроэмаштериалов .	стройматериалов / сщроэмаштериалов
авторитет евродепутата в китае не сработал : местные власти не пустили представительницу европарламента хельгу трупель к семье ныне заключенного китайского правозащитника ху дзя .	авмтворитцт евродепутата в китае не сработал : местные власти не пустили представительницу европарламента хельгу трупель к семье ныне заключенного китайского правозащитника ху дзя .	авмтворитцт евродепутата в китае не сработал : местные власти не пустили представительницу европарламента хельгу трупель к семье ныне заключенного китайского правозащитника ху дзя .	авторитет / авмтворитцт
мы хотели подчеркнуть с премьер-министром сингхом , до какой степени отношения между европой и индией носят стратегический характер , - заявил на совместной пресс-конференции по итогам саммита николя саркози . - мы решили ускорить переговоры по двустороннему соглашению о зоне свободной торговли .	мы хотели пцодчеркнутэх с премьер-министром сингхом , до какой степени отношения между европой и индией носят стратегический характер , - заявил на совместной пресс-конференции по итогам саммита николя саркози . - мы решили ускорить переговоры по двустороннему соглашению о зоне свободной торговли .	мы хотели подчеркнуто с премьер-министром сингхом , до какой степени отношения между европой и индией носят стратегический характер , - заявил на совместной пресс-конференции по итогам саммита николя саркози . - мы решили ускорить переговоры по двустороннему соглашению о зоне свободной торговли .	подчеркнуть / подчеркнуто
организаторы рассчитывали , что здесь соберется до NUM тысяч участников .	"организаторы рассчитывали, что здесь соберется до NUM тысяч участников.
"	организаторы рассчитывали , что здесь доберется до NUM тысяч участников .	соберется / доберется
один из руководителей военного крыла баскской сепаратистской группировки эта гарикоитс асиасу рубина по кличке чароки арестован на территории франции .	один из руководителей военного крыла баскской сепаратистской группировки эта гарикоитс асиасу рубина по кличке чароки арестован наб территории франции .	один из руководителей военного крыла баскской сепаратистской группировки эта гарикоитс асиасу рубина по кличке чароки арестован наб территории франции .	на / наб
ему пришлось бороться не только с соперником , но и со зрителями на трибунах , которые буквально оглушали , горячо болея за своих , - сказал санчес викарио .	ему пришлось бороться не только с соперником , но и со зрителями на лтрибуунах , которые буквально оглушали , горячо болея за своих '' , - сказал санчес викарио .	ему пришлось бороться не только с соперником , но и со зрителями на лтрибуунах , которые буквально оглушали , горячо болея за своих , - сказал санчес викарио .	трибунах / лтрибуунах
он открыто назвал это ответом москвы на планы вашингтона разместить объекты про в чехии и польше .	"он открыто назвал это ответом москвы на планы вашингтона разместить объекты про в чехии и польше.
"	он открыто назвал это ответом москвы на планы вашингтона разместить объекты про в чехии и больше .	польше / больше
оон готовится к отправке продовольствия и медикаментов для NUM тысяч человек , оказавшихся беженцами из-за недавних столкновений в демократической республике конго .	оот готовится к отправке продовольствия и медикаментов для NUM тысяч человек , оказавшихся беженцами из-за недавних столкновений в демократической республике конго .	вот готовится к отправке продовольствия и медикаментов для NUM тысяч человек , оказавшихся беженцами из-за недавних столкновений в демократической республике конго .	оон / вот
боевики , захватившие экипаж французского буксирного судна у берегов камеруна , заявили , что они приняли решение не убивать заложников , а удерживать их плену , пока их требования не будут выполнены .	боевики , захватившие экипаж французского буксирного судна у берегов камеруна , заявили , что они приняли решение не убивать заложников , а удерживать их плену , пока их требования не будут выполнены .	боевики , захватившие экипаж французского буксирного судна у берегов камеру , заявили , что они приняли решение не убивать заложников , а удерживать их плену , пока их требования не будут выполнены .	камеруна / камеру
вот смотрите , это шоколадное масло с арахисом NUM недели назад стоило NUM крон , сейчас - NUM .	вот смотрите , это шоколадное масло с аршахискм NUM недели назад стоило NUM крон , сейчас - NUM .	вот смотрите , это шоколадное масло с арахис NUM недели назад стоило NUM крон , сейчас - NUM .	арахисом / арахис
по данным корреспондента би-би-си оаны лунгеску , банковские авуары белорусских чиновников в европе также останутся замороженными .	по данным корреспондента би-би-си оаны лунлбгеску , банковские авуары белорусских чиновников в европе также останутся замороженными .	по данным корреспондента би-би-си оаны лунлбгеску , банковские авуары белорусских чиновников в европе также останутся замороженными .	лунгеску / лунлбгеску
соперники-республиканцы однако усмотрели в поступке обамы двойное дно .	"соперники-республиканцы однако усмотрели в поступке обамы ""двойное дно"".
"	соперники-республиканцы однако усмотрели в покупке обамы двойное дно .	поступке / покупке
с таким обещающим заявлением выступил на предварительном показе отснятого материала режиссер мак-джи .	с таким обещающим заявлением выступил на предварительном показе отснптгоя материала режиссер мак-джи .	с таким обещающим заявлением выступил на предварительном показе отснптгоя материала режиссер мак-джи .	отснятого / отснптгоя
ранее организаторы , обеспокоенные возможным наплывом избирателей в день выборов , обратились к гражданам с призывом проглосовать досрочно .	ранее организаторы , обеспокоенные возможным наплывом избирателей в день выборов , обратились к гражданам с призывом пзоглонсомвать досрочно .	ранее организаторы , обеспокоенные возможным наплывом избирателей в день выборов , обратились к гражданам с призывом пзоглонсомвать досрочно .	проглосовать / пзоглонсомвать
в сентябре этого года бцбк перешел на бессточную систему водопользования , чего много лет добивались экологи и природоохранные ведомства .	в сентябре этого года бцбк перешел на бессточную систему водопользования , чего много лет дрмбиваелись экологи и природоохранные ведомства .	в сентябре этого года бцбк перешел на бессточную систему водопользования , чего много лет дрмбиваелись экологи и природоохранные ведомства .	добивались / дрмбиваелись
NUM дней назад исландия получила на укрепление экономики NUM миллиарда евро от мвф и еще два - от соседей-скандинавов .	NUM дней лпназад исландия получила на укрепление экономики NUM миллиарда евро от мвф и еще два - от соседей-скандинавов .	NUM дней лпназад исландия получила на укрепление экономики NUM миллиарда евро от мвф и еще два - от соседей-скандинавов .	назад / лпназад
за счет этого годударство планирует создать NUM тысяч новых рабочих мест .	за счет этого годударство планихюуео создать NUM тысяч новых рабочих мест .	за счет этого годударство планихюуео создать NUM тысяч новых рабочих мест .	планирует / планихюуео
палестинцы возобновили ракетные обстрелы .	"палестинцы возобновили ракетные обстрелы.
"	палестинцы возобновить ракетные обстрелы .	возобновили / возобновить
но я светский человек , я атеист .	"но я светский человек, я атеист.
"	но я советский человек , я атеист .	светский / советский
примерно столько же прибавил парижский индекс сас-NUM .	сримернол столько же прибавил парижский индекс сас-NUM .	сримернол столько же прибавил парижский индекс сас-NUM .	примерно / сримернол
в этом районе находится другое пассажирское судно , которое оказывает ушуайе помощь .	в этом районе находится другое пассажирское судно , икаоторое оказывает `` ушуайе '' помощь .	в этом районе находится другое пассажирское судно , икаоторое оказывает ушуайе помощь .	которое / икаоторое
бульбов был арестован сотрудниками фсб в начале октября NUM года .	бульбов был арестован сотрудниками фсб щв начале октября NUM года .	бульбов был арестован сотрудниками фсб щв начале октября NUM года .	в / щв
в числе людей , покинувших трайдент-оберой - NUM членов экипажа компании эр франс .	в числе людей , покинувших `` трайдент-оберой '' - NUM членов экипажки компании `` эр франс '' .	в числе людей , покинувших трайдент-оберой - NUM членов экипажки компании эр франс .	экипажа / экипажки
ситуация в городе гоме , осажденном войсками повстанцев , близка к гуманитарной катастрофе .	сиъуеция в городе гоме , осажденном войсками повстанцев , близка к гуманитарной катастрофе .	сиъуеция в городе гоме , осажденном войсками повстанцев , близка к гуманитарной катастрофе .	ситуация / сиъуеция
бульбов утверждает , что расследовал коррупцию в фсб	бульбов утверждает , что расследовал коррупцию о фсб	бульон утверждает , что расследовал коррупцию о фсб	в / о
аллингэм чудом выжил в трех жесточаших битвах , в том числе при ипре : помню , меня отбросило в воронку от разрыва снаряда .	аллингэм чудом выжил в трех жесточаших битвах , в том чдислле при ипре : `` помню , меня отбросило в воронку от разрыва снаряда .	аллингэм чудом выжил в трех жесточаших битвах , в том чдислле при ипре : помню , меня отбросило в воронку от разрыва снаряда .	числе / чдислле
фритцль также обвиняется в рабовладении и изнасиловании .	фритцль также обвиняется в рабовладении з изнасиловании .	фритцль также обвиняется в рабовладении з изнасиловании .	и / з
в субботу в городе фульде в центральной германии состоялись митинг членов ультраправой национал-демократической партии и марш протста антифашистов , около NUM участников которого несли израильские флаги и лозунги фульда - зона свободная от нацистов ( отсылка к известному призыву гитлеровцев сделать германию свободной от евреев ) .	в субботу в городе фульде в центральной германии состоялись митинг членов ультраправой национал-демократической партии и марш протста антифашистов , около NUM участников которого несли израильские флаги и лозунги `` фульда - бзона свободная от нацистов '' ( отсылка к известному призыву гитлеровцев сделать германию `` свободной от евреев '' ) .	в субботу в городе фульде в центральной германии состоялись митинг членов ультраправой национал-демократической партии и марш протста антифашистов , около NUM участников которого несли израильские флаги и лозунги фульда - бзона свободная от нацистов ( отсылка к известному призыву гитлеровцев сделать германию свободной от евреев ) .	зона / бзона
опера - душа италии , как пение - основа фонетики языка , на котором разговаривают жители аппенин .	опера - душа исалхии , как пение - основа фонетики языка , на котором разговаривают жители аппенин .	опера - душа исалхии , как пение - основа фонетики языка , на котором разговаривают жители аппенин .	италии / исалхии
все трое содержатся в тюрьме особого режима нусакамбанган , где и будет приведен в исполнении приговор .	все трое содцнрцатся в тюрьме особого режима нусакамбанган , где и будет приведен в исполнении приговор .	все трое содцнрцатся в тюрьме особого режима нусакамбанган , где и будет приведен в исполнении приговор .	содержатся / содцнрцатся
по словам мишеля , главу конголезских антиправительственных группировок лорана нкунду пока не пригласили к участию в переговорах .	по словам мишеля , главу коннгелезсэких антиправительственных группировок лорана нкунду пока не пригласили к участию в переговорах .	по словам мишеля , главу коннгелезсэких антиправительственных группировок лорана нкунду пока не пригласили к участию в переговорах .	конголезских / коннгелезсэких
план действий по словам дэвида милибэнда таков : NUM тысяч военнослужащих оон находятся на данный момент в стране .	план действий по словам дэвида милибэнда таков : `` NUM тысяч военнослужащих оон находятся на данный момент в стрсуане .	план действий по словам дэвида милибэнда таков : NUM тысяч военнослужащих оон находятся на данный момент в стрсуане .	стране / стрсуане
в итоге исследователи обнаружили лишь восемь серьезных ошибок , которые они назвали неверной интерпретацией важных положений , - по четыре в каждой энциклопедии .	"в итоге исследователи обнаружили лишь восемь серьезных ошибок, которые они назвали ""неверной интерпретацией важных положений"", - по четыре в каждой энциклопедии.
"	в итоге исследователи обнаружили лишь восемь серьезных ошибок , которые они назвали неверной интерпретации важных положений , - по четыре в каждой энциклопедии .	интерпретацией / интерпретации
times при этом напоминала , что за последние три года мандельсон дважды инициировал снижение пошлин на ввоз в евросоюз алюминиевого сырья .	times при этом напоминала , что за последние три года мандельсон дважды инициировал снижение поьлих на ввоз в евросоюз алюминиевого сырья .	times при этом напоминала , что за последние три года мандельсон дважды инициировал снижение поьлих на ввоз в евросоюз алюминиевого сырья .	пошлин / поьлих
в это же время генеральная прокуратура внесла представление россвязькомнадзору в связи с нарушением прав детей в мультсериалах на канале NUMхNUM .	в это же время генеральная прокуратура внесла представление россвязькомнадзору вш связи с нарушением прав детей в мультсериалах на канале `` NUMхNUM '' .	в это же время генеральная прокуратура внесла представление россвязькомнадзору вш связи с нарушением прав детей в мультсериалах на канале NUMхNUM .	в / вш
в южном американском штате виргиния знают толк в президентах сша : NUM из них были местными жителями .	в южном американском штате вюиргёния знают толк в президентах сша : NUM из них были местными жителями .	в южном американском штате виргинии знают толк в президентах сша : NUM из них были местными жителями .	виргиния / виргинии
представители европейских социалистов и социал-демократов утвердили объединенную программу на NUM год , ознаменовав тем самым старт подготовки к выборам в европарламент ; они состоятся в июне следюущего года .	представители европейских социалистов и социал-демократов утвердили объединенную программу на NUM год , ознаменовав тем самым старт мвподготовски к выборам в европарламент ; они состоятся в июне следюущего года .	представители европейских социалистов и социал-демократов утвердили объединенную программу на NUM год , ознаменовав тем самым старт мвподготовски к выборам в европарламент ; они состоятся в июне следюущего года .	подготовки / мвподготовски
барак обама выступил с новыми предложениями в области экономики , среди которых сокращение налогов , создание новых рабочих мест и введение девяностодневного моратория на отъем жилья .	барак обама выступил с новыми предложениями в области экономики , среди которых сокращение налогов , создание новых ллрабочих мест и введение девяностодневного моратория на отъем жилья .	барак обама выступил с новыми предложениями в области экономики , среди которых сокращение налогов , создание новых ллрабочих мест и введение девяностодневного моратория на отъем жилья .	рабочих / ллрабочих
намерение бальтасара гарзона вызовет неоднозначную реакцию в испании .	намерение бальтасара оарзрона вызовет неоднозначную реакцию в испании .	намерение бальтасара оарзрона вызовет неоднозначную реакцию в испании .	гарзона / оарзрона
изъятия в россии	изъятия щ россии	изъятия у россии	в / у
